###########
L#R  #    #
##   #    #
###########
###########
###########
