####################
#******************#
#******************#
#******************#
#******************#
#******************#
#                  #
#                  #
#                  #
#                  #
#                  #
#                  #
#                  #
#                  #
#                  #
#                  #
#                  #
#                  #
#                  #
#                  #
#                  #
#                  #
#                  #
#                  #
#                  #
#                  #
#                  #
#                  #
#                  #
#                  #
#                  #
#                  #
#                  #
#                  #
#                  #
#                  #
#                  #
#                  #
#\   \      \   \  #
#         \        #
# \     \          #
#     \            #
#   \              #
# \               R#
##################L#