###############
#\* #   #   #R#  
# # # # # #   #  
# #   #   #   #  
#L#############
