###############
#\* #   #   #R#  
#   # # # #   #  
# #   #   #   #  
#L#############
