#########################
#########* ##############
#########* #####...######
#########  #.#####.######
#####*  #**#.###...######
###*#*  #  #...#.########
### #*  #  ###.#...######
###*#   #  ###.##########
### #   #  ###.##########
###*#*  #  ###########*##
### #   #  ########### ##
#R                 \\  L#
### #   #  ########### ##
### # ################ ##
#########################