##############
#* *         #
L    * *     #
#        * * #
# W   W   W  #
#            #
##############
#R       #
##########

Growth 2
Razors 3