#######################
#######* ##############
#######* #####...######
#######  #.#####.######
#######**#.###...######
###*  #  #...#.########
###*  #  ###.#...######
###*  #  ###.##########
###   #  ###.##########
###*  #  ###########*##
###   #  ########### ##
#R               \\  L#
###   #  ########### ##
### ################ ##
#######################