##L###########
#.....R#.**..#
#.*A...#..1..#
#.*....#.  \.#
#.\\\..#...\.#
#2.....**B...#
##############

Trampoline A targets 1
Trampoline B targets 2
