########
L*#***\#
#*#    #
#*# W  #
# #    #
# ##   #
#  #####
#   # R#
########

Growth 1
Razors 3
